00 00 00 00 00 00 00 00
00 00 00 00 00 00 00 00
00 00 00 00 00 00 00 00
00 00 00 00 00 00 00 00
00 00 00 00 00 00 00 00
00 00 00 00 00 00 00 00
00 00 00 00 00 00 00 00
a2 19 40 00 00 00 00 00
1c 19 40 00 00 00 00 00
fd 18 40 00 00 00 00 00
48 00 00 00 00 00 00 00
78 19 40 00 00 00 00 00
9b 19 40 00 00 00 00 00
65 19 40 00 00 00 00 00
27 19 40 00 00 00 00 00
ef 18 40 00 00 00 00 00
51 18 40 00 00 00 00 00
33 65 38 61 35 36 33 39